--#--------#----
------#----#----
--------#---#---
--#------#--#---
-##---------#---
----#-----###-#-
------#------#--
--------#--#----
------#---#-----
--#-#-------#---
---#----------#-
------#---#-----
-----#-----#-#--
----#----#------
-#-------#------
----#-------#-#-