--#---#--------#
------#-----#---
-------#----#---
-------#----#---
---#---#----#---
-----#-------#--
---#-#-----#----
-----#--#-------
--#------#---#--
---#-#--------#-
#-------#-------
-------#---#----
------#--#----#-
#---##--#---#---
----#-----#-----
----#-----------