--#-------------
----#--#---#----
-----------#--#-
----#----#------
#---#-------#---
-#--------#-----
--#-----#-----#-
------#----#----
----#----#--#---
---##---#-------
--#-----#-------
-#------#-----#-
---------##-----
----#---#-----#-
------#--#--#---
#-----#-------#-