----##---
#-------
---#--#--
---------
---------
---#---#-
-#-------
-#-------
-------#-
