---------
---------
-----#-##
---#-----
------#--
-#-----#
------#--
---------
-##------
