----#------------------#---#-----
#---------#----#--#--------#-----
-#------#---#---#---#------------
-#-----#---#-#-#--------#--#-----
------#--#--#--#--#----------#---
#------#-#-------#------#------#-
--##--#------#--#---#------#-----
--#--#-#----#-#---#--#-----------
#--#----#----#-------#--#----#---
---#-#---#---#--#-----#-------#-#
------#----#--#---#--#-----#-----
#--#---#----#---#----#------#--#-
-#--------#--#------#-----#------
--#--#--#---#---#--#--#--#-------
--#--------#--#--#--------#------
#--#--------#---#--------#----#--