---#----#----#---#-----#---------
#----#--#----#--#--#--#--#--#-#--
-----#-----#--#--#--#--#----#----
#-#---#------#----#-#----#-------
----#---#-----#--#---#--#---#--#-
---#--#-----#---#----#--#----#---
---#--#-----#-#-----#-----#---#--
--#-----#----#--#---#---------#--
---#---#----#-----#--#-----#---#-
#--#----#--#-----#--#------------
---#-----------------------------
-----#-#-----------#--#-----#--#-
----#--#--#--------#-----#-------
-#-#----#--#----------#----#--#--
----#-----#--#------#-#-----#----
#----#-#-----#-------------------