---#----#----#---#-----#------
#----#--#----#--#--#--#-#-##--
-----#-----#--#--#--#--#-#----
#-#---#------#----#-#-#-------
----#---#-----#--##--#---#--#-
---#--#-----#---#-#--#----#---
---#--#-----#-#--#-----#---#--
--#-----#---##---#---------#--
---#---#-#-----#--#-----#---#-
#--#----##----#--#------------
---#--------------------------
-----#-#--------#--#-----#--#-
----#--#--#-----#-----#-------
-#-#---##----------#----#--#--
-#-----#--#------#-#-----#----
#-#-#-----#-------------------