#----#----#------#---------#-#---
--#---#-----#-----#-#----------#-
-#---#---#-#--#---#-------#------
#----#--#----#--#----#--#----#---
-#---#-----#--#----#--#------#---
------#--#---#------#--------#-#-
---#---#-------------------------
-#-#--------#---#---#-----#------
--#--#-------#--#--#---#-----#---
----#----------#-----#--#--------
#-#--#-----#----#-#------#--#---#
----#----#-#--#--#---#-------#-#-
--#-#---#---#--------------------
#---#-----#--#----#---#-------#--
--#-----#---#-----#-#-----#---#--
---#----#----#--#----#-----------