-#------------------#---#-----
#------#----#--#--------#-----
-#---#---#---#---#------------
-#--#---#-#-#--------#--#-----
---#--#--#--#--#----------#---
#---#-#-------#------#------#-
--##--#---#--#---#------#-----
--#--#-#-#-#---#--#-----------
#--#-#----#-------#--#----#---
#-#---#---#--#-----#-------#-#
---#----#--#---#--#-----#-----
#--##----#---#----#------#--#-
-#-----#--#------#-----#------
--##-#---#---#--#--#--#-------
--#-----#--#--#--------#------
#--#-----#---#--------#----#--