#----#----#------#---------#-#
--#---#-----#-----#-#-------#-
-#---#---#-#--#---#-------#---
#----#--#----#--#----#--#-#---
-#---#-----#--#----#--#---#---
------#--#---#------#-----#-#-
---#---#----------------------
-#-#--------#--#-#-----#------
--#--#----#--#--#---#-----#---
----#-------#-----#--#--------
#-#--#--#----#-#------#--#---#
-#----#-#--#--#---#-------#-#-
--#-##---#--------------------
#---#--#--#----#---#-------#--
--#--#---#-----#-#-----#---#--
---#-#----#--#----#-----------